10
M M M M M M M M M M
M 0 0 M 0 0 0 0 0 M
M 0 1 M 0 0 0 2 0 M
M T 0 M 2 0 0 0 0 M
M 0 0 M 0 0 2 0 0 M
M 0 0 M 0 0 0 0 0 M
M M M M 0 0 0 0 T M
M 0 0 0 0 0 0 0 0 M
M 0 S 0 0 0 P 0 0 M
M M M M M M M M M M