40
M M M M M M M M M M M M M M M M M M M M M M M M M M M M M M M M M M M M M M M M
M 0 0 0 0 0 0 0 0 0 1 0 0 0 0 0 0 0 0 0 0 0 0 0 0 0 0 0 0 0 0 0 0 0 0 0 0 0 0 M
M 0 0 2 0 0 0 0 0 0 0 0 0 0 0 2 0 0 0 0 0 0 0 0 0 0 0 0 0 0 0 0 0 0 0 0 0 0 0 M
M 0 0 0 0 0 0 0 M M 0 0 0 0 0 0 0 0 0 0 0 0 0 0 0 M 0 0 0 2 0 0 0 0 0 0 0 0 0 M
M M M M M M M M M M 0 0 0 M M M M M M M M M M M M M 0 0 0 0 0 0 0 0 0 0 0 0 0 M
M 0 0 0 0 0 0 0 0 M 0 0 0 M M M M 2 0 0 0 0 0 0 0 0 0 0 0 0 0 0 0 0 0 0 0 0 0 M
M 0 0 0 0 0 0 2 0 M 0 0 0 M M M M 0 0 0 0 0 0 0 0 0 0 0 0 0 0 0 2 0 0 0 0 0 0 M
M 0 0 0 2 0 0 0 0 M 0 0 0 M M M M 0 0 0 0 0 0 0 0 0 0 0 0 0 0 0 0 0 0 0 0 0 0 M
M 0 0 0 0 0 0 0 0 M 0 0 0 0 0 0 M M 0 0 0 0 0 0 0 0 0 0 0 0 0 0 0 0 0 0 0 0 0 M
M 0 0 0 0 0 0 0 0 M 0 0 0 0 0 0 0 M 0 0 0 0 0 0 0 0 0 0 0 0 0 0 0 0 0 0 0 0 0 M
M 0 0 0 0 0 0 0 0 M M M M M M L 0 M 0 0 0 0 0 0 0 0 0 0 0 0 0 2 0 0 0 0 0 0 0 M
M P 0 0 M M 0 0 0 0 0 0 0 0 M 0 0 M 0 0 0 0 0 0 0 0 0 0 0 0 0 0 0 0 0 0 0 0 0 M
M 0 0 0 M M 0 0 0 0 0 0 0 0 M 0 0 M M 0 0 0 0 0 0 0 0 0 0 0 0 0 0 0 0 0 0 0 0 M
M 0 0 0 0 0 0 0 0 0 0 0 0 0 M 0 0 0 M 0 0 0 0 0 0 0 0 0 0 0 0 0 0 0 0 0 0 0 0 M
M 0 0 0 0 0 0 0 2 0 0 0 0 0 M 0 0 0 M M 2 0 0 0 0 0 0 0 0 0 0 0 0 0 0 0 0 0 2 M
M 0 0 0 0 0 0 0 0 0 0 0 0 0 M M M 0 0 M M M M M M M M M M M M M M M M M M M M M
M 0 0 0 0 0 0 0 0 0 0 0 0 0 0 0 M 0 0 M 0 0 0 0 0 0 0 0 0 0 0 0 0 0 0 0 0 0 0 M
M 0 0 0 2 0 0 0 0 0 0 0 0 0 0 0 M 0 0 M 0 0 0 0 0 0 0 0 0 0 0 0 0 0 0 0 0 0 0 M
M 0 0 0 0 0 0 0 0 0 0 0 0 M 0 0 M 0 0 M 0 0 0 0 0 2 0 0 0 0 0 0 0 0 0 0 0 0 0 M
M 0 0 0 0 0 0 0 0 M 0 0 0 M 0 0 M 0 0 M 0 0 0 0 0 0 0 0 0 0 0 0 0 0 0 0 0 0 0 M
M M M M M M M M M M 0 0 0 M 0 T M 0 0 0 0 0 M M M M M M M M M M M M 0 0 M M M M
M 0 0 0 0 0 0 0 0 M 0 0 0 M 0 0 M 0 0 0 0 0 M M M M M M M M M M M M 0 0 M M M M
M 0 0 2 0 0 0 0 0 M M M M M 0 0 M M M M M M M M M M M M M M M M M M 0 0 M M M M 
M 0 0 0 0 0 0 0 0 0 0 0 0 0 0 0 M 0 0 0 0 0 0 0 0 0 0 0 2 0 0 0 0 0 0 0 0 0 0 M
M 0 0 0 2 0 0 0 0 0 0 0 0 0 0 0 M 0 0 0 0 0 0 0 0 0 0 0 0 0 0 0 0 0 2 0 0 0 0 M
M 0 0 0 0 0 0 0 0 0 0 0 0 0 0 0 M 0 0 0 0 0 0 0 0 0 0 0 0 0 0 0 0 0 0 0 0 0 0 M
M 0 0 0 2 0 0 0 0 0 0 M M M M M M M M M M M M M M M 0 0 0 0 0 0 0 0 0 0 0 0 0 M
M 0 0 0 0 0 0 0 0 0 0 M 2 0 0 0 0 0 0 0 0 0 0 0 0 0 0 0 0 0 0 0 0 0 0 0 0 0 0 M
M 0 0 0 0 0 0 2 0 0 0 M 0 0 0 0 0 0 0 0 0 0 0 0 0 2 0 0 0 0 0 0 0 0 0 0 0 0 0 M
M 0 0 0 0 0 0 0 0 0 0 M 0 0 0 0 0 0 0 0 0 0 0 0 0 0 0 0 0 0 M M M M M M M M M M
M 0 0 0 0 0 0 0 0 0 0 M 0 0 0 0 0 0 0 0 0 0 0 0 0 0 0 0 0 0 M M M M M M M M M M
M M M M M M M 0 0 0 0 M 0 0 0 0 0 0 0 0 0 0 0 0 0 0 0 0 0 0 0 0 0 0 0 0 0 0 0 M
M 0 0 0 0 P M 0 0 0 0 M M M M M M M M M M 0 0 0 2 0 2 0 0 0 0 M M M M M M M 0 M
M 0 0 0 0 0 M 0 0 0 0 M 0 0 0 0 0 0 0 0 0 0 0 0 0 0 0 0 0 0 0 M 0 2 0 0 0 M 0 M
M 0 0 0 0 0 M 0 0 0 0 M 0 0 2 0 0 0 0 0 0 0 0 0 0 0 0 0 0 0 0 M 0 M M M 0 M 0 M
M 0 0 2 0 0 M M M M M M 0 0 0 0 0 0 0 0 0 0 0 0 0 0 0 0 0 0 0 M 0 M T M 0 M 0 M
M 0 0 0 0 0 0 0 0 0 0 0 0 0 0 0 0 0 0 0 0 0 0 0 0 0 0 0 0 0 0 M 0 M 0 0 P M 0 M
M 0 0 0 0 0 M M M M M M M M M 0 0 0 0 0 0 0 0 0 0 0 0 0 0 0 0 M 0 M M M M M 0 M
M 0 0 0 0 0 2 0 0 0 2 0 0 0 0 0 0 0 0 0 0 0 0 0 0 0 0 0 0 0 0 M 0 0 0 0 2 0 0 M
M M M M M M M M M M M M M M M M M M M M M M M M M M M M M M M M M M M M M M M M